11
13
XXXXXXXXXXX X
X        X  X
X XXXX XXX XX
X    X      X
X XX X XXXXXX
X XX        X
X XX XXXXXX X
X       X   X
X X X X X X X
X X X X   X X
XXXXXXXXXXXXX