9
19
XXXXXXXXXXXXXXXXXXX
X   X   X         X
X XXX X X X X XXX X
X X   X X X X     X
X XXXXX XXX X XXXXX
X     X     XXX   X
X XXXXX XXXXX X X X
X     X         X  
XXXXXXXXXXXXXXXXXXX
