9
7
XXXXXXX
X     X
XXXXX X
X     X
X XXXXX
X     X
XXXXX X
X     X
XXXXXXX
